"                                                                                                                                                                                                        
   #########################################################################################################################################################                                            
   #                           ##                           ##                           #                                                                 #                                            
   #                           ##                           ##                           #                                                                 #                                            
   #                           ##                           ##                           #                                                                 #                                            
   #                           ##                           ##                           #                                                                 #                                            
   #                           ##                                                        #                                                                 #                                            
   #                           ##                                                        #                                                                 #                                            
   #                                                        ##                           #                                                                 #                                            
   #                                                        ##                                                                                             #                                            
   #                                                        ##                           #                                                                 #                                            
   #                           ##                           ##                           #                                                                 #                                            
   #                           ##                           ##                           #                                                                 #                                            
   #                           ##                           ##                           #                                                                 #                                            
   #                           ##                           ##                           #                                                                 #                                            
   #                           ##                           ##                           #                                                                 #                                            
   ###################################################   ####################   ##########                                                                 #                                            
   #                                                         ################   ##########                                                                 #                                            
   #                                                         #                           #                                                                 #                                            
   #                                                         #                           #                                                                 #                                            
   #                                                         #                           #                                                                 #                                            
   #                                                         #                           #                                                                 #                                            
   #                                                         #                           #                                                                 #                                            
   #                                                         #                                                                                             #                                            
   #                                                         #                                                                                             #                                            
   #                                                         #                                                                                             #                                            
   #                                                         #                                                                                             #                                            
   #                                                         #                                                                                             #                                            
   #                                                         #                           #                                                                 #                                            
   #                                                                                     #                                                                 #                                            
   #                                                                                     #                                                                 #                                            
   #                                                                                     #                                                                 #                                            
   #                                                            ########   ###############                                                                 #                                            
   #                                                            ########   ###############                                                                 #                                            
   #                                                                                     #                                                                 #                                            
   #                                                         #                           #                                                                 #                                            
   #                                                         #                           #                                                                 #                                            
   #                                                         #                           #                                                                 #                                            
   #########################################################################################################################################################                                            
                                                                                                                                                                                                        
"
